16x16
++++++++++++++++
+@@@@@@@@@@@E+++
+@++++++++++++++
+@++++++++++++++
+@++@@@@@+++++++
+@++@+++@+++++++
+@@@@+++@@@@++++
++++++++@+++++++
+++++@@@@+++@+++
+++++@++++++@+++
+++++@+++@@+@+++
+++++@+++@++++++
+++++@@@@@++++++
+++++++@++++++++
+++++++@++++++++
+++++++S++++++++