16x16
++++++++++++++++
+00000000000E+++
+0++++++++++++++
+0++++++++++++++
+0++00000+++++++
+0++0+++0+++++++
+0000+++0000++++
++++++++0+++++++
+++++0000+++0+++
+++++0++++++0+++
+++++0+++00+0+++
+++++0+++0++++++
+++++00000++++++
+++++++0++++++++
+++++++0++++++++
+++++++S++++++++