===
++++++++++++++++++
++++++++++@+++++++
+++@@@++++@+++@+++
+++@@@@@@@@@@@@+++
+++@@@++++@+++@+++
+++++++++@@@++@+++
++++@++++@@@++@+++
@@@@@+++++++++@+++
@+++++@++@+@@@@+++
@+++@@@@@@+@++@+++
@++++@+@+@+@@@++++
@@@@++@++@@@+@@@++
++@++++++@@@++++++
++@++++++@@@++++++
++@@@@@@@@+@++++++
+++++++++@+@++++++
+++++++++S+@++++++
++++++++++++++++++
---