===
++++++++++++++++++
++++++++++++++++++
++++++++++++++++++
++++++++++++++++++
++++++++++@+++++++
+++++++++@@@++++++
++++++++++@+++++++
++++++++++@@@@@+++
++++@@@+++++@+++++
+++++@++@+++@+++++
+++++@+@@@@@@@@+++
+++++@++@+++++@+++
+++++@@@@@++++@+++
++++++++S+++++@+++
++++@@@@@@@@@@@+++
++++++@++++@++++++
++++++@++++@++++++
++++++++++++++++++
---