===
++++++++++++++++++
++++++++++++++++++
+@++@@@@@@@@@@@@++
+@@@@++++++++++@++
+@@@@+++++@++++@++
++@++++++@@@+++@++
++@+++++++@+++++++
++@+++++++@@@@@+++
++@@@@@+++++@+++++
++@++@++P+++@+++++
++@++@+@@@@@@@@+++
++L++@++@+++++@+++
+++++@@@@@++++@+++
++++++++S+++++@+++
++++@@@@@@@@@@@+++
++++++@++++@++++++
++++++P++++L++++++
++++++++++++++++++
---