===
++++++++++++++++++
++++++++++++++++++
++++++++++++++++++
++++++++++++++++++
++++++++++++++++++
++++++++++++++++++
++++++++++++++++++
++++++++++@@@@@+++
++++++++++++@+++++
++++++++@+++@+++++
+++++++@@@@@@@@+++
++++++++@+++++@+++
+++++++@@@++++@+++
++++++++S+++++@+++
+++++++++@@@@@@+++
+++++++++++@++++++
+++++++++++@++++++
++++++++++++++++++
---