===
++++++++++++++++++
++++++++++++++++++
++++++++++++++++++
++++++++++++++++++
++++++++++++++++++
++++++++++++++++++
++++++++++++++++++
+++@@@@@++++++++++
+++++@+++++@@@++++
+++++@+++@++@+++++
+++@@@@@@@@+@+++++
+++@+++++@++@+++++
+++@++++@@@@@+++++
+++@+++++S++++++++
+++@@@@@@@@@@@++++
++++++@++++@++++++
++++++@++++@++++++
++++++++++++++++++
---