===
++++++++++++++++++
++++++++++++++++++
++++++++++++++++++
++++++++++++++++++
++++++++++++++++++
++++++++++++++++++
++++++++++++++++++
++++++++++++++++++
+++++++++@+@++++++
+++++++++@+@++++++
+++++++++@+@++++++
+++++++++@@@++++++
+++++++++@@@++++++
+++++++++@@@++++++
+++++++++@+@++++++
+++++++++@+@++++++
+++++++++S+@++++++
++++++++++++++++++
---