===
++++++++++++++++++
++++++++++++++++++
++++++++++++++++++
++++++++++++++++++
++++++++++++++++++
++++++++++++++++++
++++++++++++++++++
+++@@@@@++++++++++
+++++@++++++++++++
+++++@+++@++++++++
+++@@@@@@@@+++++++
+++@+++++@++++++++
+++@++++@@@+++++++
+++@+++++S++++++++
+++@@@@@@@@@@@++++
++++++@++++@++++++
++++++@++++@++++++
++++++++++++++++++
---