===
++++++++++++++++++
++++++++++++++++++
++++++++++++++++++
++++++++++++++++++
++++++@+++++++++++
++++@@@@@+++++++++
++++@+++@+++++++++
++++@+@+@+++++++++
++++@+@+@+++++++++
++++@@@@@+++++++++
++++@@@@@+++++++++
++@@@@@@@@@+++++++
++@+++S+++@+++++++
++@+++@+++@+++++++
++@@@@@@@@@+++++++
++++++++++++++++++
++++++++++++++++++
++++++++++++++++++
---