===
++++++++++++++++++
++++++++++++++++++
++++++++++@+++++++
++++++++++@+++@+++
++++++++++@@@@@+++
++++++++++@+++@+++
++++++++@@@+++@+++
++++++++++++++@+++
++++++@++@+@@@@+++
++++@@@@@@+@++@+++
++++++@++@+@+@@@++
++++++@++@@@+@@@++
+++++++++@@@++++++
+++++++++@@@++++++
+++++++++@+@++++++
+++++++++@+@++++++
+++++++++S+@++++++
++++++++++++++++++
---