===
++++++++++++++++++
++++++++++++++++++
++++++++++++++++++
++++++++++++++++++
++++++++++++++++++
++++@+@+@+++++++++
++++@+@+@+++++++++
++++@+@+@+++++++++
++++@+@+@+++++++++
++++@@@@@+++++++++
++++@@@@@+++++++++
++@@@@@@@@@+++++++
++++++S+++++++++++
++++++++++++++++++
++++++++++++++++++
++++++++++++++++++
++++++++++++++++++
++++++++++++++++++
---