===
++++++++++++++++++
++++++++++++++++++
++++++++++++++++++
++++++++++++++++++
++++++++++++++++++
++++++++++++++++++
++++++++++++++++++
++++++++++++++++++
++++++++++++++++++
++++++++++++++++++
++++++++++++++++++
++++++++++@@@@@+++
++++++++++@@@@@+++
++++++++++@@@@@+++
++++++++++++@+++++
++++++++++++S+++++
++++++++++++++++++
++++++++++++++++++
---