===
++++++++++++++++++
++++++++++++++++++
++++++++++++++++++
++++++++++++++++++
++++++++++++++++++
++++++++++++++++++
++++++++++++++++++
++++++++++++++++++
++++++++++++++++++
++++++++++++++++++
+++++++++@++++++++
+++++@@@@@@@@@++++
+++++@+++@+++@++++
++++++++@@@+++++++
+++++++++@++++++++
+++++++++S++++++++
++++++++++++++++++
++++++++++++++++++
---