===
++++++++++++++++++
++++++++++++++++++
++++++++++@+++++++
+++@@@++++@+++@+++
+++@@@@@@@@@@@@+++
+++@@@++++@+++@+++
+++++++++@@@++@+++
++++@++++@@@++@+++
@@@@@+++++++++@+++
@++++++@++@+@@@@++
@+++@@@@@@+@++@+++
@++++@+@+@+@@@++++
@@@@++@++@@@+@@@++
++@++++++@@@++++++
++@++++++@@@++++++
++@@@@@@@@+@@@@+++
+++++++++@+@++++++
+++++++++S+@++++++
---