===
++++++++++++++++++
++++++++++++++++++
++++++++++++++++++
++++++++++++++++++
++++++++++++++++++
++++++++++++++++++
++++++++++++++++++
+++++@@@@+++++++++
++++++++@@@@@@++++
++++++++@+++@+++++
++++++++++++@+++++
++++++++++++@+++++
++++++++++@@@+++++
++++++++++@@@+++++
++++++++++++@+++++
++++++++++++S+++++
++++++++++++++++++
++++++++++++++++++
---