===
++++++++++++++++++
++++++++++++++++++
++++++++++++++++++
++++++++++++++++++
++++++++++++++++++
++++++++++++++++++
++++++++++++++++++
++++++++@+++++++++
++++++++@@@@@@++++
++++++++@+++@+++++
++++++++++++@+++++
++++++++++@@@@@+++
++++++++++@@@@@+++
++++++++++@@@@@+++
++++++++++++@+++++
++++++++++++S+++++
++++++++++++++++++
++++++++++++++++++
---