===
++++++++++++++++++
++++++++++++++++++
++++++++++++++++++
++++++++++++++++++
++@+++++++@+++++++
++@++++++@@@++++++
++@+++++++@+++++++
++@+++++++@@@@@+++
++@@@@@+++++@+++++
++@++@++@+++@+++++
++@++@+@@@@@@@@+++
++@++@++@+++++@+++
+++++@@@@@++++@+++
++++++++S+++++@+++
++++@@@@@@@@@@@+++
++++++@++++@++++++
++++++@++++@++++++
++++++++++++++++++
---