===
++++++++++++++++++
++++++++++++++++++
++++++++++++++++++
++++++++++++++++++
++++++++++++++++++
++++++++++++++++++
++++++++++++++++++
++++++++++@@@@@+++
++++++++++++@+++++
++++++++@+++@+++++
+++++++@@@@@@@@+++
++++++++@+++++@+++
+++++++@@@++++@+++
++++++++S+++++@+++
++++@@@@@@@@@@@+++
++++++@++++@++++++
++++++@++++@++++++
++++++++++++++++++
---