++++++++++++++++++
++++++++++++++++++
++S@@@++++++++++++
+++++@++++++++++++
+++++@@@@P++++++++
+++++++++@++++++++
+++++++++@@@@+++++
+++++++++++++@++++
++++++P@@@@@@@@+++
++++++++++++@+++++
++++++++++L+@+++++
+++++++++++++@++++
+++++++++++@@U++++
++++++++++++++++++
++++++++++++++++++
++++++++++++++++++
++++++++++++++++++
++++++++++++++++++
---
++++++++++++++++++
++++++++++++++++++
++S@@@@+++++++++++
++++++@+++++++++++
+++++P@@@@++++++++
++++++++++@+++++++
++++++++++@@L+++++
++++++++++++@+++++
+++++P@@@@@@@@++++
++++++++++++@+++++
++++++L+++++@+++++
++++++++++++@+++++
++++++++++@@@@++++
++++++++++@+++++++
++++++++P+@@U+++++
++++++++++++++++++
++++++++++++++++++
++++++++++++++++++
---
++++++++++++++++++
++++++++++++++++++
++S@@@@@@@L+++++++
++++++++@+++++++++
+++P++++@@@@++++++
++++++++++@+++++++
++++L@@@@@@@P+++++
++++++@+++++++++++
++++++@@@@@@++++++
+++++++++++@++++++
++++P+++L++@@+++++
+++++++++++@++++++
++++@@@@@@@@++++++
++++@+++++++++++++
++++@@@@P@@@U+++++
++++++++++++++++++
++++++++++++++++++
++++++++++++++++++
---
++++++++++++++++++
++++++++++++++++++
++S@@@@+++++++++++
++++++@+++++++++++
++++++@+++++++++++
+++P++@@@@++++++++
++++++++++@+++++++
++++++++++@+++++++
++++++P+++@@++++++
++++++++++@+++++++
++++++++++@@P+++++
+++++++++++@++++++
+++++++++++@@+++++
++++++++++++@+++++
++++++++++++@@E+++
++++++++++++++++++
++++++++++++++++++
++++++++++++++++++
---